%%%%%%%%%
%   o   %
%    o  %
%ooo    %
%       %
%   G   %
%    .  %
%P      %
%%%%%%%%%