%%%%%%%%%%%%%%%
%   o         %
%    o        %
%             %
%             %
%             %
% G           %
%.    P       %
%%%%%%%%%%%%%%%