%%%%%%%%%
%   o   %
%    o  %
%ooo    %
%       %
%   G   %
%%%%%%.o%
%P     o%
%%%%%%%%%