%%%%%%%%%
%   o   %
%    o .%
%   G o %
% o     %
%       %
%P      %
%%%%%%%%%