%%%%%%%%%
%   o   %
%    o  %
%       %
% G     %
%    .  %
% o     %
%P      %
%%%%%%%%%
