%%%%%%%%%%%%%%
%.          G%
%            %
%oooooo      %
%     o      %
%     o      %
%     o      %
%     o      %
%     o      %
%            %
%  P         %
%%%%%%%%%%%%%%
