%%%%%%%%%%%%%%
%Gooooooooooo%
%o          o%
%o P        o%
%o         .o%
%oooooooooooo%
%%%%%%%%%%%%%%
