%%%%%%%%%%%%%%%%%%%
%   o             %
%G  oooooooooooooo%
%               . %  
%P                %
%%%%%%%%%%%%%%%%%%%
