%%%%%%%%%
%G.     %
%%%%%%% %
%       %
% %%%%%%%
%       %
%%%%%%% %
%       %
% %%%%%%%
%      P%
%%%%%%%%%
