%%%%%%%%%%%%%%%%%%%
%         %   %   %
% %%%%%%% % % % % %  
%       % % % % % %
%%%%%%% % % % % % %
%       % % % % % %
% %%%%%%% % % % % %
%       % % % % % %
%%%%%%% %   % % % %
%       %%%%%   % %
% %%%%%%%G%%%%%%% %
%      P  .       %      
%%%%%%%%%%%%%%%%%%%
