%%%%%%%%%%%%%%
%.           %
%            %
% oooooooo G %
% ooooooo    %
% ooooooo    %
% ooooooo    %
% ooooooo    %
% ooooooo    %
%            %
%  P         %
%%%%%%%%%%%%%%
