%%%%%%%%%%%%%%
%G         oo%
%          oo%
%          .o%
%  P       oo%
%%%%%%%%%%%%%%
