%%%%%%%%%%%%%%%%%%%
%                 %
% G o             %
%         o     . %  
%P o              %
%                 %
%                 %
%%%%%%%%%%%%%%%%%%%
