%%%%%%%%%%%%%%%%%%%
%                 %
%  G              %
%         o     . %  
%P                %
%     o           %
%                 %
%%%%%%%%%%%%%%%%%%%
