%%%%%%%%%%%%%%%%%%%
%G           %    %
%    %       %    %
%    %    o  %  . %  
%P   %       %    %
%    % o     %    %
%    %            %
%%%%%%%%%%%%%%%%%%%
