%%%%%%%%%%%%%%%%%%
%G          %    %
%ooo%       %    %
%   %    o  %  . %  
%P  %       %    %
%   % o     %    %
%   %            %
%%%%%%%%%%%%%%%%%%
