%%%%%%%%%%%%%%%%%%
%G          %    %
%ooo%       %    %
%   %    o  %  . %  
%ooo%       %    %
%   % o     %    %
%P  %            %
%%%%%%%%%%%%%%%%%%
