%%%%%%%%%
%   o   %
%    o  %
%ooo    %
%    G  %
%   oo  %
%%%%  o.%
%P     o%
%%%%%%%%%