%%%%%%%%%
%       %
%       %
%  ooo  %
%. o    %
%%%oo   %
%    G  %
%P      %
%%%%%%%%%
